7:7->11:7
12:7->8:7
7:16->11:16
12:16->8:16
%
####################
#T________________T#
#__________________#
#__##__##__##__##__#
#__##__##__##__##__#
#__________________#
#T_H____________H_T#
###__##SC##CS##__###
###__##__##__##__###
#______BB__BB______#
#__________________#
#__##__##__##__##__#
#__##__##__##__##__#
#__________________#
#T_____BB__BB_____T#
###__##__##__##__###
###__##SC##CS##__###
#__________________#
#T_H____________H_T#
####################