6:8->13:11
13:8->6:11
%
####################
#T_#__#T____T#__#_T#
#__#B_#______#_B#__#
#__#__#______#__#__#
#_______HHHH_______#
#__________________#
###_##_######_##_###
#__________________#
#__H__S_B__B_S__H__#
#__________________#
#__________________#
#__H__C_B__B_C__H__#
#__________________#
###_##_######_##_###
#__________________#
#_______HHHH_______#
#__#__#______#__#__#
#__#B_#______#__#__#
#T_#__#T____T#__#_T#
####################