7:2->4:5
2:10->13:11
9:14->13:16
%
####################
#__________###_____#
#T_____S___HT_B____#
#_________________##
#_____W_______B__###
#___C_____T______###
##_____T__________##
#________#_________#
#_H______#____B____#
#_______W__________#
#_S__________T_____#
#___B_____HHHCHH___#
#__________________#
#______B________W__#
####_____S_________#
#______B_______H___#
###__________C_____#
#_____T____________#
#_______W___H______#
####################