7:2->4:5
2:10->13:11
9:14->13:16
%
####################
#__#___##_W##___#__#
#__#____#__#____#__#
#T_C____________C_T#
###______SS______###
#__________________#
##______#__#______##
#___##__#__#__##___#
##T_____H__H_____T##
###_____B__B_____###
###_____B__B_____###
##H_____H__H_____H##
#__##___#__#___##__#
#__T#B__#__#__B#T__#
#__##__________##__#
#________SS________#
#__HBH________HBH__#
#_______#CC#_______#
#W_____##TT##_____W#
####################