5:5->5:13
5:14->5:6
14:5->14:13
14:14->14:6
%
####################
#T_______##_______T#
#________##________#
#____HB______BH____#
#__________________#
#_B##SC##__##CS##B_#
#__________________#
#__________________#
#____HH__HH__HH____#
###T_##_T##T_##_T###
#____HH__HH__HH____#
#__________________#
#__________________#
#_B##SC##__##CS##B_#
#__________________#
#__________________#
#____HB______BH____#
#________##________#
#T_______##_______T#
####################