5:7->1:2
14:7->18:2
5:12->1:17
14:12->18:17
%
####################
#T_#_____##_____#_T#
#C_#_B__H##H__B_#_C#
#________W_________#
#__________________#
#_B__T___##___T__B_#
##_______BB_______##
#____S________S____#
#_H_____T##T_____H_#
###__H__####__H__###
###W_H__####__H_W###
#_H_____T##T_____H_#
#____S________S____#
#________BB________#
#_B__T___##___T__B_#
#__________________#
#________W_________#
#C_#_B__H##H__B_#_C#
#T_#_____##_____#_T#
####################