9:3->9:16
10:13->10:6
13:9->6:9
3:10->16:10
%
####################
#T________________T#
#__________________#
#__######SH######__#
#__#T_____B____T#__#
#__#____________#__#
#__#__###HC###__#__#
#__#__#______#__#__#
#__#__#_B__B_#__#__#
#__H__CB____BS__H__#
#__S__H______H__C__#
#__#__#_B__B_#__#__#
#__#__#______#__#__#
#__#__###HS###__#__#
#__#____________#__#
#__#T_____B____T#__#
#__######CH######__#
#_______B__B_____#_#
#T________________T#
####################