6:6->13:13
6:13->13:6
%
####################
#T________________T#
#_#_____B__B_____#_#
#__#____________#__#
#___H__________H___#
#____#________#____#
#_____S______C_____#
#__B___#____#___B__#
#_______#__#_______#
#________TT________#
#________TT________#
#_______#__#_______#
#__B___#____#___B__#
#_____S______C_____#
#____#________#____#
#___H__________H___#
#__#____________#__#
#_#_____B__B_____#_#
#T________________T#
####################